.........................................................................................................................................................................................................................................................................................................................................................................................................................................................N....................................................................................................................................................................................................................................................................................................................................................................
.........................................................................................................................................................................................................................................................................................................................................................................................................................................................................................................................................................................................................................................................................................................................................N....................................................................................
......................................................................................................................................................................................................................................................................................................................................................................................................................................................o.......................................................................................................................................................................................................................................................................................................................................................................
..E...................................o...............o...............o...............o...............o...............o.......................................................................................................................................................................................................................................................................................................................T#######D...............................................................................................................................................................................................................................................................................o.......................................................................................
##T###########T#######D#######T#######D#######T#######D#######T#######D#######T#######D#######T#######D#######T#######D...............o................................................................................................................................................................................................................................................................................................#######T#######D..................................................................................................................................v...............v...............v............................................................................................D#######T#######D................................................v....................v.................
##T###########T#######D#######T#######D#######T#######D#######T#######D#######T#######D#######T#######D#######T#######D#######T#######D...........o...................................................................................................................................................................o.......................P.......o...............................o.......................................T#######D#######T#######D...............................................................................................................................................................................................................................................D#######T#######D#######T#######D...........................v...........................................................
##T###########T#######D#######T#######D#######T#######D#######T#######D#######T#######D#######T#######D#######T#######D#######T#######D#######T####...................S.......o.......S.......o.......S.......o.......................o.......S.......o.......S.......o.......S.......................D#######T#######D...............D#######T#######D...............D#######T#######D...............o...............D#######T#######D#######T#######D.......................S.......o.......S.......o.......S.......o.......S.......o...............o...............o...............................................................N...N...N...N...................................D#######T#######D#######T#######D#######T#######D...............................................................................F.......
##T###########T#######D#######T#######D#######T#######D#######T#######D#######T#######D#######T#######D#######T#######D#######T#######D#######T#######D#######T#######D#######T#######D#######T#######D#######T#######D#######T#######D#######T#######D#######T#######D#######T#######D#######T#######D#######T#######D#######T#######D#######T#######D#######T#######D#######T#######D#######T#######D#######T#######D#######T#######D#######T#######D#######T#######D#######T#######D#######T#######D#######T#######D#######T#######D#######T#######D#######T#######D#######T#######D#######T#######D#######T#######D#######T#######D#######T#######D#######T#######D#######T#######D#######T#######D#######T#######D#######T#######D#######T#######D#######T#######D#######T#######D#######T#######D#######T###############
##T###########T#######D#######T#######D#######T#######D#######T#######D#######T#######D#######T#######D#######T#######D#######T#######D#######T#######D#######T#######D#######T#######D#######T#######D#######T#######D#######T#######D#######T#######D#######T#######D#######T#######D#######T#######D#######T#######D#######T#######D#######T#######D#######T#######D#######T#######D#######T#######D#######T#######D#######T#######D#######T#######D#######T#######D#######T#######D#######T#######D#######T#######D#######T#######D#######T#######D#######T#######D#######T#######D#######T#######D#######T#######D#######T#######D#######T#######D#######T#######D#######T#######D#######T#######D#######T#######D#######T#######D#######T#######D#######T#######D#######T#######D#######T#######D#######T###############
##T###########T#######D#######T#######D#######T#######D#######T#######D#######T#######D#######T#######D#######T#######D#######T#######D#######T#######D#######T#######D#######T#######D#######T#######D#######T#######D#######T#######D#######T#######D#######T#######D#######T#######D#######T#######D#######T#######D#######T#######D#######T#######D#######T#######D#######T#######D#######T#######D#######T#######D#######T#######D#######T#######D#######T#######D#######T#######D#######T#######D#######T#######D#######T#######D#######T#######D#######T#######D#######T#######D#######T#######D#######T#######D#######T#######D#######T#######D#######T#######D#######T#######D#######T#######D#######T#######D#######T#######D#######T#######D#######T#######D#######T#######D#######T#######D#######T###############
##T###########T#######D#######T#######D#######T#######D#######T#######D#######T#######D#######T#######D#######T#######D#######T#######D#######T#######D#######T#######D#######T#######D#######T#######D#######T#######D#######T#######D#######T#######D#######T#######D#######T#######D#######T#######D#######T#######D#######T#######D#######T#######D#######T#######D#######T#######D#######T#######D#######T#######D#######T#######D#######T#######D#######T#######D#######T#######D#######T#######D#######T#######D#######T#######D#######T#######D#######T#######D#######T#######D#######T#######D#######T#######D#######T#######D#######T#######D#######T#######D#######T#######D#######T#######D#######T#######D#######T#######D#######T#######D#######T#######D#######T#######D#######T#######D#######T###############
##T###########T#######D#######T#######D#######T#######D#######T#######D#######T#######D#######T#######D#######T#######D#######T#######D#######T#######D#######T#######D#######T#######D#######T#######D#######T#######D#######T#######D#######T#######D#######T#######D#######T#######D#######T#######D#######T#######D#######T#######D#######T#######D#######T#######D#######T#######D#######T#######D#######T#######D#######T#######D#######T#######D#######T#######D#######T#######D#######T#######D#######T#######D#######T#######D#######T#######D#######T#######D#######T#######D#######T#######D#######T#######D#######T#######D#######T#######D#######T#######D#######T#######D#######T#######D#######T#######D#######T#######D#######T#######D#######T#######D#######T#######D#######T#######D#######T###############
##T###########T#######D#######T#######D#######T#######D#######T#######D#######T#######D#######T#######D#######T#######D#######T#######D#######T#######D#######T#######D#######T#######D#######T#######D#######T#######D#######T#######D#######T#######D#######T#######D#######T#######D#######T#######D#######T#######D#######T#######D#######T#######D#######T#######D#######T#######D#######T#######D#######T#######D#######T#######D#######T#######D#######T#######D#######T#######D#######T#######D#######T#######D#######T#######D#######T#######D#######T#######D#######T#######D#######T#######D#######T#######D#######T#######D#######T#######D#######T#######D#######T#######D#######T#######D#######T#######D#######T#######D#######T#######D#######T#######D#######T#######D#######T#######D#######T###############