                                                                                                                                                                                                                         
                                                                                                                                                                                                                         
                                                                                                                                                                                                                         
                                                                                                                                                                                                                         
                                                                                                                                                                                                                         
                                                                                                                                                                                                                         
                                                               N                                                                                                                                                         
                                                  ###################                  v                                                                                                                                 
                                               ##########################                                                                                                                                                
                                             #############################                                                                                                                                               
                                             ###########             ##########             v                                                                                                                            
                                       ########T####                   ########                                                                                                                                          
                                 ##################      vv   v    v    ########                               v                                                                                                         
                                                                                               N                                                                                                                         
           E      #########                                                                                                      N                                                                                       
##############################      N   v     v           ###############                 ############                                                                                                                   
#TT##TT##TT##TT##TT##TT##TT###                           #####TTT############          ################                  #######                                                                                         
##############################                           #####################################TTT######                  #######                                                                                         
#####################################                        ###################TTT###################                   #######                                                                                         
#TT##TT##TT##TT##TT##TT##TT##TT##TT##                                     ################                           #########           v                    v                                                          
#####################################                                                                                ########                                    v                                                       
#############################TT##TT##    ##########                                                            ##############                                                                                            
                           ##########    ##TT##TT##                          v                                ###                                       LLL          F                                                   
                           ##TT##TT##    #####################                                                                             ############################                                                  
                           ##########    ##TT##TT##TT##TT##########             N                                     N                ##############                                                                    
                           ##TT##TT##    ###############################            LLL#####            ########            LLL#################                                                                         
                           ##########    ##TT##TT##TT##TT###################################          ###################################                                                                                
                           ##TT##TT##    ##############################################TTT##          ###################################                                                                                
                           ##########    ##TT##TT##TT##TT#######################################  G   ###################################                                                                                
                           ##TT##TT##    #######################################################      ###################################                                                                                
                           ##########    #######################################################      ###################################                                                                                