#.#####.###.#####.###.##
..#####.#.#.##.##.###...
..##.##.###.#####.#.#.#.
..#####...........###.#.
..#####...........###...
........................
.###..##.##.##.....###..
#.#.#.#####.####...###..
#####..#.#...###.##.# ##
#.#.#.#####.####.###.###
.###..##.##.##...##.#.##
...................###..
...................###..