...........................................
.#.#####.###.#####.###.##...###..##.##.##..
...#####.#.#.##.##.###.....#.#.#.#####.###.
...##.##.###.#####.#.#.#...#####..#.#...##.
...#####...........###.#...#.#.#.#####.###.
...#####...........###......###..##.##.##..
...........................................