...........................
.#.#####.###.#####.###.##..
...#####.#.#.##.##.###.....
...##.##.###.#####.#.#.#...
...#####...........###.#...
...#####...........###.....
...........................
..###..##.##.##.....###....
.#.#.#.#####.####...###....
.#####..#.#...###.##.# ##..
.#.#.#.#####.####.###.###..
..###..##.##.##...##.#.##..
....................###....
....................###....
...........................