                                                                                                                                                                                                                                                                                                                                                                                                                                                                                                                                                                   
                                                                                                                                                                                                                                                                                                                                                                                                                                                                                                                                                                   
                                                                                                                                                                                                                                                                                                                                                                                                                                                                                                                                                                   
                                                                                                                                                                                                                                                                                                                                                                                                                                                                                                                                                                   
                                                                                                                                                                                                                                                                                                                                                                                                                                                                                                                                                                   
                                                                                                                                                                                                                                            IIIIIII      IIIIIIII                                                                                                                                                                                                                                                                                                  
                                                                                                                                                                                                                                            IIIIIII      IIIIIIII                                                                                                                                                                                                                                                                                                  
                                                                                                                                                                                                                                      I                  IIIIIIII                                                                                                                                                                                                                                                                                                  
                                                                                                                                                                                                                                                                                                                                                                                                                                                                                                                                                                   
                                                                                                                                                                                                                              ####                                                    I#####                                                                                                                                                                                                                                                                      F
                                                                                                                                                                                                                              ####                                   ######            ########                                           ########                                                                                                                                                                                      O       III O   O  O O  OII
                                                                                                                                                                                                                         I                                             ########II#################                                       ############                                                                                                                                                               ##I#II###       IIIIIIIIIIIIIIIIIIIIIIIIIIIIIII
                                                                                                                                                                                                                                                                       ###############################                                  ##############                                                                                                                                                     III       ##I#I##        IIIIIIIIIIIIIIIIIIIIIIIIIIIIIII
                                                                                                                                                                                                                   I                                                  ##################################                               ###############                                                                                                                                                     I#I        #I###         IIIIIIIIIIIIIIII#IIIIIIIIIIIIII
                                                                                                                                                                                                                                                                      #####################################                            ################                                                     I   ###I#########                                                                      III     I#I        ####          III#IIIIIIIIIIIIIIIIIIIIIIIIIII
                                                                                                                                                                                                             II                                                       ######################################                         I#################                                                     ##################                                                                     III     I#I         #I#          IIIII#IIIIIIIIII#IIIIIIIIIIIIII
                                                                                                                                                                                                             II         ######                                       ###I####################################                        II##################                                                    ###I################                                                          IIII            I#I         ###          III#I#II#IIIII#III#IIIIIIIIIIII
                                                                                                                                                                                                    IIIII              #######       ######       #####             #########################################    ###I                II#I################                                      ######       # ##I###I###I#########                                                         IIII            I#I         ###           III#IIII#I#II#II#II####       
                                                                                                                                                                                                    IIIII        ########I####       ######       ####              ##I########I#####################################                IIIIIII##########I###                                      ####I       ##I################I####                                      I   IIIIIIII I           III     I#I          I             IIII##I#III#II#III####       
                                                                                                                                                                                              ##                ######I#######       ###I########I#####              ######I##########################################I#II#IIIIIII   III#IIII###I############                        #######    I##           ##I#################I####     I                          B  I   II     # IPPPPPPPPPPPIII    BI#I                          III#IIII#III#I#I####       
                                                                                                                                                                                              ##               ###############       ################I#######       #################################I######I#####I#####I#III#IIII   IIIIIIII####I###      I                         ##I####     ###        # ###########################  II                #####I###I###II #I#     #####I######I#######I####PPPPPPPPPPP                ##I##II###I##I#####       
                                                                                                                                                                                     IIII     ################I###############       ##########I#######I#####       #########I#####I######I######I#######I##############IIIIIIIIII   II#II#II##I####       I                ####I#   ######     ### #       ##I#######################I########        ########I##I#I##III####I      I I#######I#######I#####I####II###I#                 #I#I###I#I#I######       
                                                                                                                                                                                              #########I######################       ######################I#        ##I######I#########################I###    #####I##III#IIIIII   IIIIIIII####                            #####   #I####     ####I        ####################I##########            ###I#####I#######I##I##      #######I#######I#####I####I######I##                  ###II###I#I######       
                                                                                                                                                                             IIIII            ###I############################       #########################        ####I########     ########I###I#####         ######IIIIII#II      IIIII##                 ####I####   I###I     ###I##    ##I##       ################I  I   ### ##        IIII##   ##I#######I#####I###        ###I######I#I#####I#########I######                    ####I###I######       
                                                                                                                                                                                              ################################       #####################I###         ##    ##            ##########I###               IIIIIIIIII     IIIIII           ####I############   ####     #######     ###        #######I#### I  I  I    I            II####  #########I###########         ##I############################I##                     #I#I##########       
                                                                                                                                                                    ######                    ################################       ##################I########                                ##                                  I                ###I#########I######   ####I    #I####I    ####         #####I#  I     I       I        II##I###   I  ###################          #################################                     #######I######       
                                           B                                                                                                                        ######                    ################################       ########################I###                                                                   I          ##### #######I############   #I#I##   # #I###    #I###                                    ##I  I     I P #   ###I##############                             ##############                     #I#I####I#####       
                                         #####                                                                                          IIII                    ####I#####                    #########            ###########       #####################I##########     #######       ######                        B IIIII#IIIIIIII#IIIIII##I##I# #################I##   ######   #######    #####                                    #  I   IPIP#########################                                   #########                      #####I#######       
                                          I                                                                                    IIII     IIII   II   B           ##########                    #########            ###########       #############################I############I#####   ###I#######I#I###      B ########II#III#III#IIIIIIIII####### ####################   #I####   ####I##    ### #       ########I####I######I###I######PI ##########I###################                                       ######                       ##I#########       
                                                                                                                      IIII              ##################I###I###########                    #########            ###########       #########     #######################I##########   ######I################I#####I##I#IIIIII#IIIIIII#IIII#I##### ####################    ###I#   ##I####    I####        ###I###I####I####I######I#################################                                               ###                        ###########       
                                                                                                         IIIIIIIII                      #####I#########I##################                    #########            ###########       ########       ################I#############I##   ######I#########I###########I###I#III#IIIIII#II#IIIII####### ####################   ######   ## ####    ##I##       #I########I#####I########I##########I#####I###############                                                                           ##I########       
                                              B                                   B                      IIIIIIIII                      ###########################I######                    #########            ###########       ########            ###############I############   ###########I##########I####I####IIIIIIIIII#IIIIIIIIII####### ####################   ###I##   #######  P# ####       #####I#I##################################################                                                                           ####I######       
                         #########I###############I### #####PPPP#######  ###########  ######     ####I################                  #####I############################                    #########            ###########       ########                 #######################   ################################III#IIIIIIIIIIIIIIIII####### ####################   ######    #######I##I####       ##I###########################################                                                                                       I##########       
                         #############I###############P################  #####I#####  ######     ###############I#####                  ##################################                    #########            ###########       ########                    ####################   ################################IIIIIIIIIIIIIIIIIIIII####### ####################   #I####   ###I###########I       ##############################################                                                                                       ##I########       
                   ########################I#################I#########  ###########            ####I#########I#######                  ##################################                    #########            ###########       ########                              ##########   ################################             IIIIIIII####### ####################   ######   #######I## #####       ###I##########                                                                                                                       ###########       
      E          B ######I###I#########################################  ###########PP          ######################                  #######                 ##########                    #########            ###########       ########                              ##########   ###########                                  IIIIIIII####### ################## #   ##I###   # ###########I##       ######I#######                                                                                                                       #####I#####       
   ####################################################################  #############################################                  #######                 ##########                    #########            ###########       ########                              ##########   ###########                                  IIIIIIII####### ####################   ######   ##############I#       ####I#########                                                                                                                        ##########       
 #####I######I####I####################################################  ## ###   # ##################################                  #######                 ##########                    #########            ###########       ########                              ##########   ###########                                  IIIIIIII####### ####################   #####I   ######I###I####I       ####I#########                                                                                                                        ##########       
#######################################################################  ## ### # # ##################################                  #######                 ##########                    #########            ###########       ########                              ##########   ###########                                  IIIIIIII####### ####################   ######   #####I#####I####       #I############                                                                                                                        I#########       
#######################################################################  ##   #   #   ################################                  #######                 ##########                    #########            ###########       ########                              ##########   ###########                                  IIIIIIII####### ####################   #I####   ###### #########       #####I########                                                                                                                        ##########       
#################################                            ##########  #############################################                  #######                 ##########                    #########            ###########       ########                              ##########   ###########                                  IIIIIIII####### ####################   ###I##   ####I#########I#       ####I#########                                                                                                                        ##########       
############################                                 ##########  #############################################                  #######                 ##########                    #########            ###########       ########                              ##########   ###########                                  IIIIIIII####### ####################   ######   ### #####I######       ##############                                                                                                                        ####I#####       
