#                                                                                                                               #
#                                                                                                                               #
# E                           M                                                                                                 #
###                    ########      M                                                                                          #
############       ############PPPPPPP      #        PP   PPP    PPP   P   P                                         S      M   #
#################################################################################################################################