#                                                                                                                               #
#                                                                                                                               #
# E                    G      M            G                                                                                    #
###                    ########      M                                                                                          #
############       ############PPPPPPP      #        PP   PPP    PPP   P   P         G                               S      M   #
#################################################################################################################################