                                                                                                                                        
                    S                                                                                                                   
  E             ########                                                                                                                
###############################                                                                                                         
#####################################                                                                                                   
###########################################                                                                                #####                
###############################################                                                                    #############             
###################################################                                                        #####################        
###########################################################                                        #####################################
###################################################################                        #############################################
###########################################################################        #####################################################
########################################################################################################################################