                                                                                                                                                                                                                                                                                                                                                                                                                                                                        
                                                                                                                                                                                                                                                                                                                                                                                                                                                                        
                                                                                                                                                                                                                                                                                                                                                                                                                                                                        
                                                                                                                                                                                                                                                                                                                                                                                                                                                                        
                                                                                                                                                                                                                                                                                                                                                                                                                                                                        
                                                                                                                                                                                                                                                                                                                                                                                                                                                                        
                                                                                                                                                                                                                                                                                                                                                                                                                                                                        
                                                                                                                                                                                                                                                                                                                                                                                                                                                                        
                                                                                                                                                                                                                                                                                                                                                                                                                                                                        
                                                                                                                                                                                                                                      IIIIIII      IIIIIIII                                                                                                                                                                                                             
                                                                                                                                                                                                                                      IIIIIII      IIIIIIII                                                                                                                                                                                                             
                                                                                                                                                                                                                                I                  IIIIIIII                                                                                                                                                                                                             
                                                                                                                                                                                                                                                                                                                                                                                                                                                                        
                                                                                                                                                                                                                        ####                                                    I#####                                                                                                                                                                                  
                                                                                                                                                                                                                        ####                                   ######            ########                                           ########                                                                                                                            
                                                                                                                                                                                                                   I                                             ########II#################                                       ############                                                                                                                         
                                                                                                                                                                                                                                                                 ###############################                                  ##############                                                                                                                        
                                                                                                                                                                                                             I                                                  ##################################                               ###############                                                           F                                                            
                                                                                                                                                                                                                                                                #####################################                            ################                                                         ##########################                                    
                                                                                                                                                                                                        II                                                      ######################################                         I#################                                                     ##############################                                    
                                                                                                                                                                                                        II        ######                                       ###I####################################                        II##################                                                   ##############################                                    
                                                                                                                                                                                               IIIII             #######       ######       #####             #########################################    ###I                II#I################                                      ######       ##############################                                    
                                                                                                                                                                                               IIIII        #######I####       ######       ####              ##I########I#####################################                IIIIIII##########I###                                     ######       ##############################                                    
                                                                                                                                                                                         ##                #####I#######       ###I########I#####              ######I##########################################I#II#IIIIIII   III#IIII###I############                        #######   ######       ##############################                                    
                                                                                                                                                                                         ##               ##############       ################I#######       #################################I######I#####I#####I#III#IIII   IIIIIIII####I###      I                         #######   ######       ##############################                                    
                                                                                                                                                                                  IIII   ################I##############       ##########I#######I#####       #########I#####I######I######I#######I##############IIIIIIIIII   II#II#II##I####       I                ######   #######   ######       ##############################                                    
                                                                                                                                                                                         #########I#####################       ######################I#        ##I######I#########################I###    #####I##III#IIIIII   IIIIIIII####                           ######   #######   ######       ##############################                                    
                                                                                                                                                                           IIIII         ###I###########################       #########################        ####I########     ########I###I#####         ######IIIIII#II      IIIII##                 ####I####   ######   #######   ######       ##############################                                    
                                                                                                                                                                                         ###############################       #####################I###         ##    ##            ##########I###               IIIIIIIIII     IIIIII           ####I############   ######   #######   ######       ##############################                                    
                                                                                                                                                                   #####                 ###############################       ##################I########                                ##                                  I                ###I#########I######   ######   #######   ######        #############################                                    
                                           B                                                                                                                       #####                 ##########I####################       ########################I###                                                                   I          ##### #######I############   ######   #######   ######                                                                         
                                         #####                                                                                          IIII                    ####I###                 ###############################       #####################I##########     #######       ######                         BIIIII#IIIIIIII#IIIIII##I##I# ####################   ######   #######   ######                                 F                                       
                                                                                                                               IIII     IIII   II   B           ########                 ###############################       #############################I############I#####   ###I#######I#I###       B########II#III#III#IIIIIIIII####### ####################   ######   #######   ######       ##############################                                    
                                                                                                                      IIII              ##################I###I#########                 ###############################       #####################################I##########   ######I################I#####I##I#IIIIII#IIIIIII#IIII#I##### ####################   ######   #######   ######       ##############################                                    
                                                                                                         IIIIIIIII                      #####I#########I################                 ###############################       ###############################I#############I##   ######I#########I###########I###I#III#IIIIII#II#IIIII####### ####################   ######   #######   ######       ##############################                                    
                                           B                                                             IIIIIIIIIF                     ###########################I####                 ###############################       ###################################I############   ###########I##########I####I####IIIIIIIIII#IIIIIIIIII####### ####################   ######   #######   ######       ##############################                                    
                         #########I###############I### #####PPPP#######  ###########  ######     ####I################                  #####I##########################                 ###############################       ################################################   ################################III#IIIIIIIIIIIIIIIII####### ####################   ######   #######   ######       ##############################                                    
                         #############I################################  #####I#####  ######     ###############I#####                  ################################                 ###############################       ################################################   ################################IIIIIIIIIIIIIIIIIIIII####### ####################   ######   #######   ######       ##############################                                    
                   ########################I#################I#########  ###########            ####I#########I#######                  ################################                 ###############################       ################################################   ################################IIIIIIIIIIIIIIIIIIIII####### ####################   ######   #######   ######       ##############################                                    
      E            ######I###I#########################################  ###########            ######################                  ################################                 ###############################       ################################################   ################################IIIIIIIIIIIIIIIIIIIII####### ####################   ######   #######   ######       ##############################                                    
   ####################################################################  #############################################                  ################################                 ###############################       ################################################   ################################IIIIIIIIIIIIIIIIIIIII####### ####################   ######   #######   ######       ##############################                                    
 #####I######I####I####################################################  #############################################                  ################################                 ###############################       ################################################   ################################IIIIIIIIIIIIIIIIIIIII####### ####################   ######   #######   ######       ##############################                                    
#######################################################################  #############################################                  ################################                 ###############################       ################################################   ################################IIIIIIIIIIIIIIIIIIIII####### ####################   ######   #######   ######       ##############################                                    
#######################################################################  ## ###   # ##################################                  ################################                 ###############################       ################################################   ################################IIIIIIIIIIIIIIIIIIIII####### ####################   ######   #######   ######       ##############################                                    
#######################################################################  ## ### # # ##################################                  ################################                 ###############################       ################################################   ################################IIIIIIIIIIIIIIIIIIIII####### ####################   ######   #######   ######       ##############################                                    
#######################################################################  ##   #   #   ################################                  ################################                 ###############################       ################################################   ################################IIIIIIIIIIIIIIIIIIIII####### ####################   ######   #######   ######       ##############################                                    
#######################################################################  #############################################                  ################################                 ###############################       ################################################   ################################IIIIIIIIIIIIIIIIIIIII####### ####################   ######   #######   ######       ##############################                                    
#######################################################################  #############################################                  ################################                 ###############################       ################################################   ################################IIIIIIIIIIIIIIIIIIIII####### ####################   ######   #######   ######       ##############################                                    
