#                                                                                                                               #
#                                                                                                                               #
# E                                           G                                                                                 #
###                                  G                                                                                          #
############                                                                                                                  F #
#################################################################################################################################