                                                                                                                                                                                                                                                                                                                                                                                                                                                                                                                                             
                                                                                                                                                                                                                                                                                                                                                                                                                                                                                                                                             
                                                                                                                                                                                                                                                                                                                                                                                                                                                                                                                                             
                                                                                                                                                                                                                                                                                                                                                                                                                                                                                                                                             
                                                                                                                                                                                                                                                                                                                                                                                                                                                                                                                                             
                                                                                                                                                                                                                                                                                                                                                                                                                                                                                                                                             
                                                                                                                                                                                                                                                                                                                                                                                                                                                                                                                                             
                                                                                                                                                                                                                                                                                                                                                                                                                                                                                                                                             
                                                                                                                                                                                                                                                                                                                                                                                                                                                                                                                                             
                                                                                                                                                                                                                                      IIIIIII      IIIIIIII                                                                                                                                                                                                                                                                                  
                                                                                                                                                                                                                                      IIIIIII      IIIIIIII                                                                                                                                                                                                                                                                                  
                                                                                                                                                                                                                                I                  IIIIIIII                                                                                                                                                                                                                                                                                  
                                                                                                                                                                                                                                                                                                                                                                                                                                                                                                                                             
                                                                                                                                                                                                                        ####                                                    I#####                                                                                                                                                                                                                                                       
                                                                                                                                                                                                                        ####                                   ######            ########                                           ########                                                                                                                                                                                                 
                                                                                                                                                                                                                   I                                             ########II#################                                       ############                                                                                                                                                                                              
                                                                                                                                                                                                                                                                 ###############################                                  ##############                                                                                                                                                     IIII                                    
                                                                                                                                                                                                             I                                                  ##################################                               ###############                                                                                                                                                     IIII                                    
                                                                                                                                                                                                                                                                #####################################                            ################                                                         ###I#########                                                                      IIII    IIII                                    
                                                                                                                                                                                                        II                                                      ######################################                         I#################                                                     ##################                                                                     IIII    IIII                                    
                                                                                                                                                                                                        II        ######                                       ###I####################################                        II##################                                                    ###I################                                                          IIII            IIII                                    
                                                                                                                                                                                               IIIII             #######       ######       #####             #########################################    ###I                II#I################                                      ######       # ##I###I###I#########                                                         IIII            IIII                                    
                                                                                                                                                                                               IIIII        #######I####       ######       ####              ##I########I#####################################                IIIIIII##########I###                                      ####I       ##I################I####                                      I   II      II           IIII    IIII                                    
                                                                                                                                                                                         ##                #####I#######       ###I########I#####              ######I##########################################I#II#IIIIIII   III#IIII###I############                        #######    I##           ##I#################I####     I                             I   II      IIPPPPPPPPPPPIIII    IIII                                    
                                                                                                                                                                                         ##               ##############       ################I#######       #################################I######I#####I#####I#III#IIII   IIIIIIII####I###      I                         ##I####     ###        # ###########################  II                #####I###    II #I###########I######I#######I#########################################
                                                                                                                                                                                  IIII   ################I##############       ##########I#######I#####       #########I#####I######I######I#######I##############IIIIIIIIII   II#II#II##I####       I                ####I#   ######     ### #       ##I#######################I########        ########I##I#####PP#########I#I#I#######I#######I#####I####II###############################
                                                                                                                                                                                         #########I#####################       ######################I#        ##I######I#########################I###    #####I##III#IIIIII   IIIIIIII####                            #####   #I####     ####I        ####################I##########            ###I#####I#######I##################I#######I#####I####I###################################
                                                                                                                                                                           IIIII         ###I###########################       #########################        ####I########     ########I###I#####         ######IIIIII#II      IIIII##                 ####I####   I###I     ###I##    ##I##       ################I  I   ### ##        IIII##   ##I###################I###############I#I#####I#########I################################
                                                                                                                                                                                         ###############################       #####################I###         ##    ##            ##########I###               IIIIIIIIII     IIIIII           ####I############   ####     #######     ###        #######I#### I  I  I    I            II####  ################################I#########################################################
                                                                                                                                                                   #####                 ###############################       ##################I########                                ##                                  I                ###I#########I######   ####I    #I####I    ####         #####I#  I     I       I        II##I###   I  ########################################################################################
                                           B                                                                                                                       #####                 ##########I####################       ########################I###                                                                   I          ##### #######I############   #I#I##   # #I###    #I###                                    ##I  I     I P #   ###I###################################################################################
                                         #####                                                                                          IIII                    ####I###                 ###############################       #####################I##########     #######       ######                         BIIIII#IIIIIIII#IIIIII##I##I# #################I##   ######   #######    #####                                    #  I   IPIP###############################################################################################
                                          I                                                                                    IIII     IIII   II   B           ########                 ###############################       #############################I############I#####   ###I#######I#I###       B########II#III#III#IIIIIIIII####### ####################   #I####   ####I##    ### #       ########I####I######I###I######PI ##########I##########################################################################################
                                                                                                                      IIII              ##################I###I#########                 ###############################       #####################################I##########   ######I################I#####I##I#IIIIII#IIIIIII#IIII#I##### ####################    ###I#   ##I####    I####        ###I###I####I####I######I#############################################################################################################
                                                                                                         IIIIIIIII                      #####I#########I################                 ###############################       ###############################I#############I##   ######I#########I###########I###I#III#IIIIII#II#IIIII####### ####################   ######   ## ####    ##I##       #I########I#####I########I##########I#####I############################################################################################
                                           B                                                             IIIIIIIIIF                     ###########################I####                 ###############################       ###################################I############   ###########I##########I####I####IIIIIIIIII#IIIIIIIIII####### ####################   ###I##   #######  P# ####       #####I#I###############################################################################################################################
                         #########I###############I### #####PPPP#######  ###########  ######     ####I################                  #####I##########################                 ###############################       ################################################   ################################III#IIIIIIIIIIIIIIIII####### ####################   ######    #######I##I####       ##I####################################################################################################################################
                         #############I###############P################  #####I#####  ######     ###############I#####                  ################################                 ###############################       ################################################   ################################IIIIIIIIIIIIIIIIIIIII####### ####################   #I####   ###I###########I       #######################################################################################################################################
                   ########################I#################I#########  ###########            ####I#########I#######                  ################################                 ###############################       ################################################   ################################IIIIIIIIIIIIIIIIIIIII####### ####################   ######   #######I## #####       ###I###################################################################################################################################
      E            ######I###I#########################################  ###########            ######################                  ################################                 ###############################       ################################################   ################################IIIIIIIIIIIIIIIIIIIII####### ################## #   ##I###   # ###########I##       ######I################################################################################################################################
   ####################################################################  #############################################                  ################################                 ###############################       ################################################   ################################IIIIIIIIIIIIIIIIIIIII####### ####################   ######   ##############I#       ####I##################################################################################################################################
 #####I######I####I####################################################  #############################################                  ################################                 ###############################       ################################################   ################################IIIIIIIIIIIIIIIIIIIII####### ####################   #####I   ######I###I####I       ####I##################################################################################################################################
#######################################################################  #############################################                  ################################                 ###############################       ################################################   ################################IIIIIIIIIIIIIIIIIIIII####### ####################   ######   #####I#####I####       #I#####################################################################################################################################
#######################################################################  ## ###   # ##################################                  ################################                 ###############################       ################################################   ################################IIIIIIIIIIIIIIIIIIIII####### ####################   #I####   ###### #########       #####I#################################################################################################################################
#######################################################################  ## ### # # ##################################                  ################################                 ###############################       ################################################   ################################IIIIIIIIIIIIIIIIIIIII####### ####################   ###I##   ####I#########I#       ####I##################################################################################################################################
#######################################################################  ##   #   #   ################################                  ################################                 ###############################       ################################################   ################################IIIIIIIIIIIIIIIIIIIII####### ####################   ######   ### #####I######       #######################################################################################################################################
#######################################################################  #############################################                  ################################                 ###############################       ################################################   ################################IIIIIIIIIIIIIIIIIIIII####### ####################   ######   ##I##### #######       ##I####################################################################################################################################
#######################################################################  #############################################                  ################################                 ###############################       ################################################   ################################IIIIIIIIIIIIIIIIIIIII####### ####################   ######   ################       #######################################################################################################################################
