##                                                                                                                              #
##                                                                                                                              #
##  E                                                                                                                           #
##                     ########                                                                                                 #
############       ############                                                                                                 #
#################################################################################################################################