                                                                                                     
                                                                                                     
#####                                                                                                
#####                                                                                                
#####                                                                                                
######                                                                                               
######                                                                                               
######                                                                                               
######E                                                                                              
#######                                                                                              
#######                                                                                              
#######                                                                                              
########                                                                                             
########                                                                                             
#########                                                                                            
##########                                                                                           
##########                                                                                           
###########                                                                                          
############                                                                                F        
###############                                                                          ############
#########################   ########    M                               #####      ##################
#########################   ################       M       ######       #############################
########################     ####################################        ############################
#####################           #############################              ##########################
###########                               #############                         #####################