                                                                                                                                                                                                                                                                                                                                                                        
                                                                                                                                                                                                                                                                                                                                                                        
                                                                                                                                                                                                                                                                                                                                                                        
                                               #########                                                                                                                                                                                                                                                                                                                
                                              ############                                                                                                                                                                                                                                                                                                              
                                              ############                                                                                                                                                                                                                                                                                                              
                                               ############                                                                                                                                                                                                                                                                                                             
                                                     #######                                                                                                                                                                                                                                                                                                            
                                                       ######                                                                                                                                                                                                                                                                                                          #
    E            ######PP#####              ###        #######                                                                                                                                                                                                                                                                                                          
   #######        #############     ############       ###########                                                                                                                                                                                                                                                                                                      
    ####  ####     #####  ###        ############       ###########                                                                                                                                                                                                                                                                                                     
      ######        ##     #          ###########       ############                                                                                                                                                                                                                                                                                                    
                                       ##########       ###########                                                                                                                                                                                                                                                                                                     
                                        ##########      # ##  ######                                                                                                                                                                                                                                                                                                    
                                         ##########            ##################################################################################################################################                                                                                                                                                                       
                                         ##########         B ###################################################################################################################################                                                                                                                                                                       
                                        ############     ########################################################################################################################################                                                                                                                                                                       
                                        #############          ##################################################################################       ###      ###  ###########################                                                                                                                                                                       
                                        ############         B ##################################################################################B                    ###########################                                                                                                                                                                       
                                         #############   #####  ####################################################################################                F #############################                                                                                                                                                                     
                                       ################    ##################################                     #################################     #####   ##############################                                                                                                                                                                          
                                      #################     ################################                       ####          ################       #####   ############################                                                                                                                                                                            
                                    #####################              ###################                         ###         B ##############       #######   ############################                                                                                                                                                                            
                                   #######################               #################            B  B  B  B           ######   #########       #########PPP#####################################                                                                                                                                                                   
                                    ###########################PP ###       ##############  #####################                                 #####################################################                                                                                                                                                                 
                                    ###################################        ##   #       #########################                           ########################################################                                                                                                                                                                
                                     #####################################                   ###########################                PP    ########################################################                                                                                                                                                                  
                                       #######################################        ################################################################################################################                                                                                                                                                                  
                                       ##################################################################################################################################################################                                                                                                                                                               
                                       ##################################################################################################################################################################                                                                                                                                                               
                                       ##################################################################################################################################################################                                                                                                                                                               
                                       ##################################################################################################################################################################                                                                                                                                                               
                                       ##################################################################################################################################################################                                                                                                                                                               
                                                                                                                                                                                                                                                                                                                                                                        
                                                                                                                                                                                                                                                                                                                                                                        
