#                                                                                                                               #
#                                                                                                                               #
# E                                                                                                                             #
###                    ########                                                                                                 #
############       ############PPPPPPP      #        PP   PPP    PPP   P   P                                                    #
#################################################################################################################################