#                                                                                                                               #
#                                                                                                                               #
# E                                           GGGGGGGGGGGGGGGGGGGGGGGGGGGG                                                      #
###                                  G                                                                                          #
############                                                                                                                  F #
#################################################################################################################################