#                                                                                                                               #
#                                                                                                                               #
# E                         B M                                                                                                 #
###                    ########      M                                                                                          #
############       ############PPPPPPP      #        PP   PPP    PPP   P   P   B       B                  BBBB       S      M   #
#################################################################################################################################