              
   #     #           
    #   #    
   #######   
  ## ### ##  
 ########### 
 # ####### # 
 # #     # # 
    ## ##    
             